TTTTTTTTTTTTTTTTTT
T P    R      R PT
T   TTTTTT   P   T
T R      P   R   T
T  P  R      T   T
T  R     R     P T
T P   TTTTT   R  T
T P  R     R   P T
T   P  R    P BWBT
TTTTTTTTTTTTTTTTTT