TTTTTTTTTTTTTTT
TTTTTTTTTTTTT T
T TTTTTTTTTTTTT
T   T T   T   T
TTT T TTT T TTT
T   T     T   T
T R TTTTTTT R T
T       P     T
T TTTTT TTTTT T
T     R BWB   T
TTTTTTTTTTTTTTT