TTTTTTTTTTTTTTTTTT
T    P  P      R T
T        R       T
T         P  P   T
T   R  P         T
T                T
T      R   P     T
T    R  R        T
T             BWBT
TTTTTTTTTTTTTTTTTT