TTTTTTTTTTTTTTTTTT
T P      R     P T
T     R      R   T
T  TTTTT   P     T
T   R    P    R  T
T       R      P T
T P   R      P   T
T     R  R     P T
T   P     R  BWB T
TTTTTTTTTTTTTTTTTT