TTTTTTTTTTTTTTT
TTTTTTTTTTTTTTT
T   R   T  P  T
T       T     T
TTTT    TTT   T
T             T
T   TTTTT   R T
T   T         T
T   T   R     T
T      BWB    T
TTTTTTTTTTTTTTT